575,576,577,578,575,576,577,578,575,576,575,575,576,577,575,575,576,575,555,575,555,556,575,576,577,555,555,556,555,556
555,556,557,558,555,556,557,558,555,556,557,558,575,576,577,578,577,578,575,575,575,555,575,576,577,575,555,556,555,555
575,576,577,578,35,34,35,34,35,34,35,34,35,34,35,578,575,576,577,578,35,575,575,576,577,578,575,555,555,555
555,556,557,558,555,556,557,558,555,556,557,558,555,556,557,558,555,556,557,558,555,556,557,558,555,556,557,555,555,556
575,576,577,578,575,576,577,578,575,576,577,578,575,576,577,578,575,576,577,578,575,576,577,578,575,576,577,575,555,556
555,556,557,558,555,556,557,558,555,556,557,558,555,556,557,558,555,556,557,558,555,556,557,558,555,556,557,558,555,555
575,576,577,578,575,576,577,578,575,576,577,578,575,576,35,34,35,34,35,34,35,576,577,578,575,576,577,578,555,555
555,556,557,558,555,556,557,558,555,556,557,558,555,556,15,14,15,14,15,14,15,14,557,558,555,556,557,555,556,555
575,576,577,578,575,576,577,578,575,576,577,578,575,576,35,34,35,34,35,34,35,34,35,578,575,576,577,555,556,555
555,556,557,558,555,556,557,558,555,556,557,558,555,556,15,14,15,14,15,14,15,14,15,558,555,556,557,555,556,555
575,576,577,578,575,576,577,578,575,576,577,578,575,34,35,34,35,34,35,34,35,34,35,578,575,576,577,555,556,555
555,556,557,558,555,556,557,558,555,556,557,558,555,14,15,14,15,14,15,14,15,14,15,558,555,556,557,555,556,555
575,576,577,578,575,576,577,578,575,576,35,34,35,34,35,34,35,34,35,34,35,34,35,578,575,576,577,555,556,555
555,556,557,558,555,556,557,558,555,556,15,14,15,14,15,14,15,14,15,14,15,14,15,558,555,556,557,555,556,175
575,576,577,578,575,576,577,578,575,576,35,34,35,34,35,34,35,34,35,34,35,34,35,578,575,576,577,555,556,175
555,556,557,558,555,556,557,558,555,556,15,14,15,14,15,14,15,14,15,14,15,14,15,558,555,556,557,575,555,555
575,576,577,578,15,576,577,578,575,576,35,34,35,34,35,34,35,34,35,34,35,34,35,34,35,34,35,34,555,555
555,556,557,558,15,556,557,558,555,556,15,14,15,14,15,14,15,14,15,14,15,14,15,14,15,14,15,14,575,555
575,576,577,578,35,34,577,578,575,34,35,34,35,34,35,34,35,34,35,34,35,34,35,34,35,34,35,34,575,575
555,556,557,558,555,556,557,558,555,556,557,558,555,556,557,558,555,556,557,558,555,556,557,558,555,556,557,558,555,556
575,576,577,578,575,576,577,578,575,576,577,578,575,576,577,578,575,576,577,578,575,576,577,578,575,576,577,578,575,576
555,556,557,558,555,556,557,558,555,556,557,558,555,556,557,558,555,556,557,558,555,556,557,558,555,556,557,558,555,556
575,576,577,578,575,576,577,578,575,576,577,578,575,576,577,578,575,576,577,578,575,576,577,578,575,576,577,578,575,576
555,556,557,558,555,556,557,558,555,556,557,558,555,556,557,558,555,556,557,558,555,556,557,558,555,556,557,558,555,556
575,576,577,578,575,576,577,578,575,576,577,578,575,576,577,578,575,576,577,578,575,576,577,578,575,576,577,578,575,576
555,556,557,558,555,556,557,558,555,556,557,558,555,556,557,558,555,556,557,558,555,556,557,558,555,556,557,558,555,556
575,576,577,578,575,576,577,578,575,576,577,578,575,576,577,578,575,576,577,578,575,576,577,578,575,576,577,578,575,576
555,556,557,558,555,556,557,558,555,556,557,558,555,556,557,558,555,556,557,558,555,556,557,558,555,556,557,558,555,556
575,576,577,578,575,576,577,578,575,576,577,578,575,576,577,578,575,576,577,578,575,576,577,578,575,576,577,578,575,576
555,556,557,558,555,556,557,558,555,556,557,558,555,556,557,558,555,556,557,558,555,556,557,558,555,556,557,558,555,556
